1 1 1 1 1 1 1 1 1 1 1 1 1 1 1 1 1 1 1 1 1
1 0 0 1 1 0 0 0 0 0 0 0 0 1 1 1 1 1 1 1 1
1 0 0 0 0 0 0 0 1 0 0 0 0 0 0 0 1 0 1 0 1
1 0 0 1 0 1 0 0 0 0 1 0 0 1 0 0 1 0 1 0 1
1 0 0 0 0 0 0 0 1 0 0 0 0 0 0 0 1 0 1 0 1
1 0 0 0 0 1 0 0 0 0 1 0 0 1 0 0 1 0 1 0 1
1 0 0 0 0 0 0 0 1 0 0 0 0 0 0 0 1 0 1 0 1
1 0 0 0 0 1 0 0 0 0 1 0 0 1 0 0 1 0 1 0 1
1 0 0 0 0 0 0 0 1 0 0 0 0 0 0 0 1 0 1 0 1
2 0 4 5 0 0 0 0 2 4 5 0 3 0 6 0 0 0 6 7 5
2 0 4 5 0 0 0 0 2 4 5 0 3 0 6 0 0 0 6 7 5
2 0 4 5 0 0 0 0 2 4 5 0 3 0 6 0 0 0 6 7 5
1 2 0 4 5 0 0 0 0 2 4 5 0 3 0 6 0 0 0 6 7
2 4 4 5 6 0 8 1 2 4 5 7 3 5 6 2 4 5 6 7 5
2 4 4 5 6 0 8 1 2 4 5 7 3 5 6 2 4 5 6 7 5
3 4 7 6 3 0 5 8 7 5 3 0 0 0 0 0 0 1 1 1 1
2 4 4 5 6 0 8 1 2 4 5 7 3 5 6 2 4 5 6 7 5
2 4 4 5 6 0 8 1 2 4 5 7 3 5 6 2 4 5 6 7 5
2 4 4 5 6 0 0 0 0 0 0 0 3 5 6 2 4 5 6 7 5
2 4 4 5 6 3 8 1 2 4 5 0 3 5 6 2 4 5 6 7 5
2 0 4 5 0 0 0 0 2 4 5 0 3 0 6 0 0 0 6 7 5
2 0 4 5 0 0 0 0 2 4 5 0 3 0 6 0 0 0 6 7 5
2 0 4 5 0 0 0 0 2 4 5 0 3 0 6 0 0 0 6 7 5
2 0 4 5 0 0 0 0 2 0 0 0 3 0 6 0 0 0 6 7 5
2 0 4 5 0 0 0 0 2 4 5 0 3 0 6 0 0 0 6 7 5
